1111111111
1C000000E1
1111100111
1000V00001
1100001111
1000C00001
1010011111
10000000P1
1111111111
