1111111111111
11100010E0111
110C000000011
1000110000001
10011V0010001
1P000001110C1
1111111111111
