111111111111
111000C00011
111000000001
110000100C01
100V01110001
100000100001
1P0000000111
11000E001111
111111111111
