111111111111111111111111111
1E0000000000C11111100011011
1111111000000000000C0011001
1P11110V0C10011000000000001
10000000011101100000000C001
111111100000011000111000011
111111111111111111111111111
