1111111
1000001
1110101
101V101
1011101
1000001
1PCE001
1111111
