11111111111
1CCCCCCCCC1
1CCCCCCCCC1
1CCCCCECCC1
10000000001
11111111101
1P000000001
11111111111
